1111111111111
10010000000C1
1000010111001
1P1011E0C0001
1111111111111
